13 10 11 9 8 8 7 7 7 9 9 9 6 6 7 8 7 5 7 9 9 6 6 5 4 10 9 9 5 4 4 4 4 5 5 5 3 5 5 8 3 3 9 8 12 10 3 3 4 6 6 7 4 2 3 3 6 5 5 4 5 6 13 13 14 12 10 12 11 9 8 7 6 7 16 17 10 10 5 6 9 11 11 11 11 11 13 13 13 13 10 10 11 15 12 10 10 11 11 11
8 9 11 8 8 8 9 8 7 6 9 13 10 5 8 5 4 4 5 4 5 4 5 5 4 7 4 4 5 5 5 4 4 4 4 3 4 8 7 13 5 5 8 8 10 5 4 3 4 5 7 6 5 4 3 3 4 4 5 4 6 6 10 14 19 12 12 14 14 12 11 6 5 7 8 10 8 6 5 8 10 11 11 11 11 13 14 13 13 12 10 11 13 14 12 8 10 11 11 10
12 13 8 7 8 9 10 12 6 5 8 12 14 7 5 4 3 4 5 5 5 5 6 8 6 3 3 10 5 5 5 4 2 4 4 5 10 6 5 9 9 6 9 7 4 3 3 5 5 12 10 4 5 5 3 3 3 4 4 4 4 4 6 11 12 13 17 15 17 14 10 8 5 6 7 7 8 5 5 9 10 11 11 11 12 13 13 13 13 11 11 11 15 12 11 8 10 11 11 10
8 11 7 8 6 9 12 15 8 5 9 8 10 8 4 6 5 5 6 6 6 5 7 6 6 5 5 8 5 4 3 4 4 3 4 5 13 7 5 5 5 5 6 4 4 4 3 9 9 8 9 6 5 3 5 4 3 3 4 4 4 5 5 7 6 11 17 16 13 10 8 10 7 6 5 5 6 4 7 9 10 11 11 11 12 13 13 12 11 11 11 14 13 11 9 9 10 10 10 11
12 11 11 10 6 9 9 11 7 7 10 7 7 6 7 13 11 5 8 8 7 5 3 5 5 5 6 5 5 7 4 4 4 3 5 4 7 9 5 4 6 6 7 4 2 4 4 6 6 8 10 5 3 4 5 4 5 4 4 4 4 4 3 3 7 7 14 14 10 8 12 9 9 6 4 4 5 5 8 10 10 10 10 11 12 13 13 11 11 11 12 15 12 11 10 10 10 10 11 11
14 13 12 7 6 7 6 7 8 6 8 5 5 6 14 12 9 6 6 6 5 6 6 5 4 5 4 5 6 2 4 5 4 4 4 3 4 9 6 5 7 8 6 4 5 5 4 6 6 7 10 3 3 3 4 6 8 4 4 7 5 8 8 5 7 9 9 8 9 7 10 9 13 8 6 7 6 8 9 10 10 11 10 13 13 13 12 10 11 11 14 13 11 11 10 9 10 11 11 11
12 8 8 6 5 7 6 5 5 7 8 4 5 7 11 6 6 6 3 5 5 5 5 6 6 6 5 4 6 4 4 8 5 3 4 4 3 5 6 5 8 5 6 5 5 4 10 5 5 6 10 4 4 4 11 10 14 8 9 5 5 13 19 9 6 10 9 12 10 10 9 9 16 10 6 6 5 9 10 10 10 10 11 13 13 13 11 11 11 12 15 11 11 11 10 8 11 11 10 11
15 13 9 7 7 8 7 5 4 5 9 4 5 6 6 3 3 4 4 5 6 6 6 5 5 5 6 6 3 3 4 14 9 4 3 4 6 6 5 8 9 4 5 8 6 11 17 10 15 6 6 3 4 6 11 9 8 12 8 6 8 6 15 10 7 9 8 12 16 14 8 12 17 14 13 5 5 10 10 11 11 10 12 13 12 11 11 11 11 15 12 11 11 10 8 10 11 11 11 11
12 10 12 10 7 8 6 5 7 7 8 5 6 6 6 5 7 7 7 6 4 4 5 5 5 3 4 6 4 3 4 5 6 4 3 5 4 4 4 4 8 6 4 5 6 11 10 7 10 10 5 3 5 7 6 4 4 9 8 6 10 6 8 13 9 8 6 10 18 16 6 9 11 14 13 5 7 10 11 11 11 12 12 13 10 10 11 11 13 14 10 11 11 10 10 11 11 11 11 10
13 13 11 7 7 9 7 6 8 10 7 7 6 5 5 5 6 6 7 4 3 3 4 4 3 3 3 4 5 5 7 5 3 4 6 4 3 4 3 4 4 4 3 3 6 5 4 6 13 12 2 4 5 8 5 3 5 5 4 6 11 7 5 5 8 9 6 11 14 13 7 7 12 11 9 9 8 10 11 11 10 13 13 13 10 10 11 12 15 11 11 11 11 11 10 11 11 11 10 10
15 10 6 5 9 7 6 8 8 6 7 6 7 6 5 6 5 4 4 3 3 5 3 3 3 3 2 4 4 5 6 4 2 4 4 3 3 3 4 3 3 4 3 3 4 3 4 5 9 5 4 9 9 6 4 3 5 5 3 6 7 4 4 3 7 7 6 10 9 9 6 8 11 10 8 10 9 10 12 10 11 13 14 13 11 10 11 15 12 10 11 11 12 11 10 11 11 10 10 11
15 7 4 5 7 8 7 8 9 8 8 6 6 5 6 6 4 3 3 3 2 4 2 3 4 4 4 3 3 6 6 6 4 6 4 3 3 3 3 3 3 3 3 3 3 3 3 4 5 3 11 13 15 4 3 3 5 5 2 4 7 9 5 7 8 7 6 6 10 13 6 14 18 14 6 7 10 10 11 11 13 13 13 12 11 10 12 13 10 11 11 11 11 10 10 11 10 10 11 10
8 9 8 5 5 9 10 7 4 7 7 4 4 5 6 5 4 2 3 3 3 3 3 3 2 3 4 3 3 4 5 5 4 5 6 4 6 7 5 3 3 2 2 3 4 3 3 4 5 4 7 14 12 5 2 3 10 7 4 8 4 8 8 12 8 9 8 6 7 14 9 13 19 14 6 7 10 12 11 12 13 13 11 11 11 10 13 10 11 11 11 11 11 10 11 11 10 10 10 10
13 13 8 7 7 9 14 10 5 6 7 4 4 5 5 4 3 3 3 4 4 3 7 5 2 2 3 3 2 2 3 4 4 4 4 4 4 5 4 3 4 4 3 4 8 9 5 4 3 6 4 14 14 4 2 3 6 8 6 5 4 3 8 14 9 7 8 10 9 10 11 12 16 7 7 9 11 12 10 13 13 12 11 11 11 11 11 11 10 11 11 11 11 10 10 11 10 10 11 10
16 11 7 10 14 12 15 13 8 7 6 6 6 5 4 4 4 3 3 4 4 4 8 5 3 3 3 3 4 3 3 3 5 5 4 4 4 3 3 3 3 4 6 3 4 9 6 10 3 5 7 9 16 4 7 12 7 10 11 7 4 3 4 10 9 11 11 11 10 8 7 13 17 13 11 11 11 10 11 14 14 11 11 11 11 11 11 11 10 11 10 10 11 10 10 11 10 10 11 10
9 11 11 7 10 11 9 5 6 7 7 6 4 5 4 3 5 3 2 4 4 4 4 4 5 3 3 4 5 3 4 4 5 5 5 4 3 2 3 4 4 4 5 3 3 3 5 5 8 6 9 8 8 3 10 15 14 14 10 5 4 3 3 4 10 12 11 14 9 13 7 6 15 20 18 11 10 10 13 14 12 11 11 11 11 11 10 10 11 11 10 10 10 11 12 11 10 10 10 10
7 11 11 8 5 9 10 6 6 6 7 5 5 5 3 3 3 3 3 2 3 3 3 4 3 2 3 3 4 3 5 3 3 3 4 3 3 4 5 4 4 3 3 2 3 13 13 12 14 15 17 16 14 15 20 19 16 17 8 9 12 4 4 4 8 9 13 15 13 13 6 8 10 17 15 8 10 12 14 11 11 11 11 11 11 11 10 11 11 11 10 10 11 12 11 11 10 10 10 10
13 13 9 8 8 8 6 4 4 5 6 3 5 4 4 3 3 3 3 4 3 3 4 4 4 8 6 4 6 6 14 10 4 3 3 2 2 7 11 7 3 6 2 12 13 15 14 12 13 14 17 20 14 16 20 19 20 100 100 10 9 4 4 3 7 9 14 14 16 16 9 10 9 12 7 8 12 13 13 11 11 10 11 11 11 11 11 11 10 11 11 11 11 11 11 10 10 10 10 11
13 16 14 9 8 8 5 3 2 6 9 4 3 3 3 3 2 3 4 5 5 4 3 6 7 9 12 4 5 9 15 16 6 4 2 2 2 10 16 6 10 12 12 12 14 16 15 13 15 17 16 16 15 19 18 18 100 100 20 6 5 6 5 3 8 6 6 11 10 11 9 9 7 12 6 11 13 14 12 11 11 11 11 11 10 11 12 11 10 11 11 10 11 11 11 10 9 10 10 10
12 16 14 12 7 7 5 4 4 7 8 3 2 3 4 4 3 3 5 5 5 3 3 3 6 6 7 2 7 14 17 16 5 4 3 3 5 5 14 10 19 16 15 12 14 17 14 16 19 19 14 14 16 20 20 20 100 100 20 15 19 7 5 5 8 6 7 10 9 9 6 6 11 8 9 11 13 13 12 12 11 11 11 11 11 11 12 11 10 11 11 10 11 11 11 10 10 11 10 10
12 16 15 12 5 8 4 4 5 6 7 3 3 4 5 3 3 3 5 4 3 3 5 4 4 5 3 6 6 16 18 18 7 4 6 5 12 5 5 20 17 17 14 11 15 20 16 18 20 19 16 14 20 20 20 20 18 18 15 20 19 15 12 8 9 8 6 8 12 11 8 9 8 6 12 12 13 12 12 11 11 11 10 11 11 11 12 11 11 11 11 10 10 10 10 11 11 11 10 10
11 14 15 12 4 8 4 3 3 5 7 3 4 5 5 5 3 4 4 4 3 5 6 5 5 5 8 10 4 13 19 16 11 4 9 8 16 11 2 13 18 19 12 12 14 20 14 20 20 20 19 16 18 20 20 16 20 20 14 20 20 15 12 14 9 8 6 13 15 12 9 9 7 9 14 13 11 11 11 11 11 11 11 11 11 11 11 11 11 11 11 10 10 10 10 11 11 11 10 10
10 12 14 14 6 7 4 3 3 5 8 3 4 4 4 4 4 5 3 3 4 5 6 7 6 6 8 13 11 12 18 18 15 4 7 11 14 16 18 13 20 20 14 15 13 16 14 20 20 18 15 15 19 19 17 20 20 18 14 15 14 15 20 11 10 11 9 9 10 12 7 7 7 12 14 12 10 11 11 11 11 11 11 11 11 11 11 11 11 11 10 10 10 10 10 11 11 11 10 10
9 12 12 14 10 7 5 3 4 6 7 4 5 5 5 5 5 4 4 5 4 5 6 6 5 7 7 8 14 10 18 17 16 4 7 14 13 20 20 12 20 20 16 18 16 12 14 20 20 14 14 15 14 17 20 19 16 18 20 20 17 15 20 20 14 12 15 12 8 6 5 7 10 13 14 11 11 11 11 11 11 11 11 10 11 11 11 11 11 9 10 11 10 10 10 11 11 11 10 10
11 12 9 12 14 8 4 4 4 5 7 5 4 5 6 5 5 3 4 4 3 4 3 4 5 5 6 6 10 9 17 17 17 8 4 13 14 20 20 16 13 20 16 18 19 12 15 20 20 14 13 15 18 20 17 13 15 20 20 17 20 20 19 19 9 11 13 10 14 6 6 6 12 14 13 11 12 12 11 11 11 11 10 11 11 11 11 10 10 10 10 10 10 10 10 11 11 9 9 10
11 10 10 12 15 11 6 4 3 4 6 3 4 5 4 4 5 3 4 4 3 4 5 3 4 4 5 4 3 5 16 17 17 6 3 10 20 20 20 20 17 16 17 17 20 13 14 20 20 12 13 16 20 17 14 17 20 20 20 20 20 20 20 19 19 8 10 9 12 7 4 8 14 14 12 12 12 12 11 11 10 10 11 11 11 11 11 10 11 11 10 10 10 10 10 10 9 10 11 11
9 12 12 12 14 13 7 5 3 5 7 3 4 5 4 3 3 4 6 4 5 6 5 5 4 4 6 6 4 1 10 12 14 6 2 7 20 20 19 20 20 14 13 20 20 18 14 20 16 12 14 17 14 14 20 20 20 20 20 18 20 20 20 17 18 6 7 8 8 6 5 11 14 12 11 11 11 11 12 11 10 11 11 11 11 10 11 10 11 11 10 10 10 10 10 10 10 11 11 11
8 11 12 12 13 13 5 4 3 5 7 3 5 6 4 3 3 3 3 3 6 5 5 6 7 6 13 14 9 3 2 5 4 3 2 5 15 14 14 15 20 20 12 20 20 20 14 19 13 13 15 14 14 20 20 20 20 19 19 19 17 16 15 18 18 6 8 11 6 5 7 13 13 11 11 11 11 11 11 11 11 11 11 10 10 11 11 10 11 11 10 10 9 10 11 10 10 11 11 11
9 9 9 10 11 14 7 3 5 6 7 3 5 4 4 4 4 4 4 6 4 4 5 6 6 8 8 8 6 5 2 2 2 3 3 3 14 14 20 18 20 20 14 20 20 20 13 14 13 12 13 13 19 20 20 18 18 15 14 15 15 14 15 18 18 7 8 10 11 5 8 14 12 12 12 11 11 11 12 12 11 11 10 11 11 11 11 10 11 10 10 10 10 10 11 10 10 11 11 11
13 11 9 10 11 14 11 4 5 5 8 5 5 7 7 5 5 3 4 9 8 5 6 7 6 6 5 6 7 5 5 2 2 4 3 3 14 14 16 19 20 20 18 16 20 20 13 12 13 14 13 20 20 18 15 15 15 14 14 14 14 14 14 18 18 9 9 7 11 7 9 13 12 11 11 11 11 11 12 12 11 11 11 11 11 11 11 10 10 10 11 11 10 11 11 10 10 11 10 10
13 12 12 9 11 12 12 8 6 7 10 5 6 9 8 5 4 3 3 4 8 7 5 5 4 7 7 7 8 6 5 3 2 2 3 3 14 15 15 15 17 20 20 14 20 20 14 12 13 14 15 20 17 15 15 14 14 15 14 13 12 14 15 19 18 10 11 9 8 9 9 11 11 11 11 11 11 12 12 11 11 11 11 11 11 10 10 11 11 11 11 11 10 11 10 10 10 11 10 10
14 12 14 10 12 10 13 9 10 9 10 6 5 7 6 5 5 5 3 4 6 7 4 4 4 5 6 7 7 5 3 2 4 3 2 2 14 18 18 18 14 18 19 17 15 20 14 12 14 14 15 15 15 15 14 14 13 13 13 12 13 14 14 17 18 10 12 10 8 10 9 12 11 12 12 11 11 11 11 11 11 11 11 11 11 10 11 11 11 11 11 11 10 10 10 10 10 10 10 10
13 12 15 12 10 11 9 8 10 9 8 5 8 8 4 7 7 9 5 4 4 5 3 4 4 5 6 6 7 6 3 2 3 4 2 2 12 16 20 17 13 17 19 20 14 15 14 13 14 15 15 15 15 14 14 14 14 15 16 13 14 15 15 16 18 10 9 7 9 9 9 12 11 12 11 11 11 11 11 11 11 11 10 10 10 11 11 11 10 11 11 10 10 10 10 9 10 10 10 11
13 12 15 14 9 7 4 5 10 7 7 2 7 9 5 6 5 2 1 4 3 3 4 4 4 5 6 7 6 5 4 3 3 3 3 2 12 14 20 20 15 14 18 20 17 13 13 13 14 15 14 14 14 14 14 13 14 15 16 14 14 14 14 16 18 7 5 8 9 8 9 12 11 12 11 12 11 11 11 11 10 11 11 11 10 11 10 11 10 11 11 10 10 10 11 11 11 10 10 11
14 13 15 15 13 6 6 5 7 7 6 2 3 4 6 6 3 2 2 4 4 3 3 3 4 4 5 5 5 5 4 4 2 3 3 3 12 13 19 20 18 16 15 20 20 16 12 13 13 14 14 13 15 16 14 14 14 14 14 13 14 13 13 16 19 6 6 7 9 8 9 11 12 12 11 12 11 11 11 11 11 11 11 11 10 11 10 10 9 10 10 11 11 11 11 11 11 10 10 11
13 12 16 15 15 7 5 4 5 6 6 1 1 5 4 4 2 2 3 4 4 4 6 3 4 4 4 5 5 6 6 6 3 2 3 3 12 12 20 20 19 16 19 20 20 15 13 13 13 14 14 15 20 20 17 15 14 17 16 16 12 13 13 18 19 7 6 8 10 8 9 12 11 11 11 12 11 11 11 11 11 11 11 11 10 10 10 10 10 11 11 11 11 11 11 11 11 10 10 11
13 13 16 16 15 7 5 3 7 5 6 1 1 6 5 3 2 2 2 5 6 7 8 6 4 4 4 5 4 5 6 5 3 2 2 3 3 12 14 20 20 17 20 20 18 14 13 13 13 14 14 17 20 16 17 16 15 18 20 15 13 13 14 18 9 6 7 10 11 8 9 12 11 11 11 12 11 11 11 11 11 11 10 11 11 11 11 11 10 11 11 11 11 11 11 11 11 10 10 11
13 13 16 16 16 7 5 3 4 5 7 1 2 5 4 4 2 2 3 3 3 7 9 7 3 4 5 5 4 5 5 4 2 2 2 4 3 12 13 20 20 20 20 20 20 13 14 13 13 14 14 13 13 13 16 17 18 15 14 14 13 13 13 16 9 8 9 10 10 8 10 11 11 11 11 12 11 11 11 10 11 11 12 11 11 11 11 11 11 11 11 11 11 11 11 11 11 10 10 11
15 12 15 16 15 7 6 4 3 5 7 1 2 4 3 5 3 3 3 2 3 4 6 4 4 4 5 6 5 5 4 3 2 2 2 4 5 3 11 18 20 20 20 20 20 13 14 13 13 14 13 13 12 13 15 14 14 13 14 13 13 13 13 6 7 9 11 10 10 8 10 11 11 11 11 11 11 11 11 11 11 11 12 11 11 11 11 11 11 11 11 11 10 10 10 10 9 9 10 11
14 12 15 15 15 6 6 5 3 5 8 3 2 4 2 4 3 2 3 2 3 6 7 4 4 4 5 6 5 5 5 4 3 4 4 4 3 4 2 13 20 20 20 20 17 13 13 13 14 14 12 12 12 13 15 16 14 13 14 13 18 13 3 6 7 9 10 10 10 8 10 11 12 11 11 12 11 12 11 11 11 11 12 11 11 10 10 10 11 10 10 10 10 10 10 10 11 11 11 11
13 11 14 16 15 6 8 7 6 4 4 4 5 6 5 7 8 5 4 1 2 3 5 4 4 4 4 4 4 4 4 4 4 3 4 3 3 4 3 12 14 20 20 15 14 14 13 13 14 14 12 12 14 15 15 15 14 13 13 14 17 13 3 6 7 8 10 10 10 8 10 11 11 11 12 12 11 13 11 11 11 11 11 10 10 10 10 11 11 11 11 11 11 11 11 11 11 11 11 11
13 11 13 15 15 5 9 10 7 5 4 4 4 4 2 8 9 5 2 2 2 2 3 3 4 4 5 4 3 3 4 5 5 3 3 3 3 4 3 3 12 15 17 13 13 14 13 13 13 13 12 13 13 13 14 14 14 13 13 13 14 5 4 6 7 8 10 10 10 8 10 12 11 11 11 12 11 12 12 11 11 11 11 11 11 11 11 11 11 11 11 11 11 11 11 10 11 11 10 10
14 11 13 15 15 5 9 9 3 3 4 2 2 2 1 8 9 3 2 2 2 3 2 3 4 4 4 4 3 4 4 5 5 3 2 2 2 2 3 3 3 2 13 13 14 14 12 12 12 12 12 12 12 12 14 15 14 12 13 6 4 3 3 6 7 8 10 10 10 8 10 11 11 11 11 12 11 11 12 11 11 11 11 11 11 11 11 11 11 11 11 11 11 11 11 10 11 11 10 10
14 11 13 14 15 5 9 8 2 3 3 2 1 2 1 8 9 2 2 2 2 2 3 3 3 3 4 4 3 2 4 4 6 4 2 2 2 2 3 3 3 2 2 12 15 14 12 12 12 12 12 12 12 12 14 16 13 12 3 5 2 2 2 5 6 8 10 10 10 7 10 11 11 11 11 12 11 11 12 11 11 11 11 11 11 11 11 11 11 11 11 11 11 11 11 10 11 11 10 10
14 10 13 13 15 5 9 8 2 2 3 2 2 2 1 7 9 1 2 2 2 2 2 2 2 3 3 4 3 2 2 3 4 5 3 2 2 2 3 3 3 3 2 2 4 14 12 12 12 12 12 12 12 12 14 16 4 2 2 6 2 2 2 5 6 8 10 10 10 8 10 11 11 11 11 11 10 11 12 11 11 11 11 11 11 10 11 11 11 11 11 10 11 11 11 10 10 11 11 10
16 10 13 13 14 5 9 8 2 3 3 2 2 2 1 6 10 2 2 2 2 2 2 3 3 3 3 4 4 3 2 3 3 4 4 3 2 2 2 3 2 2 3 2 5 3 2 2 2 2 1 2 2 2 4 6 4 2 3 6 1 2 2 5 110 110 120 110 110 7 11 11 12 12 11 12 11 11 12 13 11 11 11 11 11 11 11 11 11 10 10 10 11 10 10 10 10 10 9 9
14 10 13 13 14 5 9 8 2 4 4 2 2 2 1 6 10 2 2 2 2 3 2 3 3 3 3 5 4 2 2 2 4 4 3 3 3 2 2 2 2 2 3 2 6 3 2 2 2 2 2 2 2 2 4 5 4 2 3 6 2 2 3 5 6 8 10 10 10 7 11 11 11 11 11 12 11 11 13 13 11 11 12 11 12 11 11 11 11 11 11 11 11 11 11 12 11 11 10 11
14 10 13 13 15 5 9 9 2 3 3 2 2 2 1 7 10 2 2 2 2 3 2 2 4 5 5 5 6 4 4 3 3 4 2 3 4 2 2 3 2 2 3 3 6 3 2 2 2 1 1 1 1 2 5 5 5 2 2 6 2 2 3 5 6 8 9 10 10 7 11 12 11 11 11 12 12 11 12 13 11 11 12 11 11 11 11 11 11 11 11 11 12 11 11 12 11 11 10 11
14 10 13 13 14 4 9 9 2 3 3 2 2 1 1 10 9 2 5 4 3 2 2 2 3 2 3 4 3 3 2 3 3 3 3 3 3 3 2 2 3 3 3 2 6 3 2 2 3 2 1 1 1 1 5 5 4 3 3 6 2 2 3 5 6 8 9 10 10 7 11 11 11 11 11 11 13 12 13 12 11 11 11 11 11 11 11 11 11 11 11 11 11 11 12 12 11 11 10 11
15 11 14 13 12 4 9 10 5 4 4 5 3 2 3 10 11 6 4 5 4 5 3 2 3 4 4 4 4 4 4 4 3 3 3 3 3 3 3 3 3 3 3 2 3 3 4 4 4 4 4 4 4 4 6 6 5 3 4 6 3 3 4 5 6 8 9 10 10 7 11 11 11 11 11 11 12 12 13 12 11 11 11 11 11 11 11 11 11 11 11 11 11 11 12 12 11 11 10 10
16 10 14 12 11 3 9 11 6 6 4 6 6 6 6 10 13 8 6 4 5 6 6 6 5 5 6 4 4 5 5 5 6 4 4 4 4 4 4 4 5 5 5 5 4 5 5 6 5 5 6 6 6 6 6 6 5 4 5 7 4 4 4 5 6 8 9 10 10 7 11 11 11 11 11 12 12 11 13 11 10 11 11 11 11 11 11 11 10 10 10 11 11 11 12 12 11 11 10 11
15 10 13 12 11 4 9 11 6 8 4 7 7 7 7 10 13 8 7 7 7 8 7 9 7 6 6 6 7 7 7 7 6 6 7 8 8 7 7 7 7 7 7 7 6 6 6 6 6 6 6 6 6 6 6 6 6 6 6 6 5 5 4 4 6 8 10 10 10 7 11 11 12 12 11 12 11 12 12 11 10 11 11 11 11 11 11 11 11 10 10 10 10 10 10 10 11 11 10 10
15 10 13 12 11 4 9 11 7 6 4 7 7 7 7 10 14 9 9 8 8 9 8 10 8 8 8 8 8 9 9 9 9 9 9 9 9 9 9 9 9 9 9 8 9 9 9 8 8 8 8 8 8 8 6 7 7 8 7 7 6 6 5 5 5 7 10 10 10 8 12 11 11 12 11 11 11 12 12 11 11 11 11 11 11 11 11 11 11 10 10 10 12 11 11 10 9 9 10 10
14 10 12 12 11 4 9 11 7 5 4 7 8 8 8 10 14 9 10 10 10 10 9 11 9 9 9 9 9 9 9 9 9 10 9 10 9 9 10 10 10 9 10 9 10 10 10 10 10 10 10 10 10 9 7 7 8 9 8 8 7 7 6 6 6 6 9 10 10 7 11 11 11 11 11 12 12 12 12 11 12 12 11 11 11 11 11 11 10 10 10 10 12 11 11 11 11 11 11 10
14 10 12 11 10 3 9 11 7 6 5 8 8 9 9 10 14 10 10 10 10 11 10 12 10 10 10 9 10 10 10 10 10 11 10 11 10 10 10 10 10 10 10 10 9 10 10 11 11 10 10 10 7 10 8 8 8 9 8 8 8 8 7 6 5 6 8 10 9 7 11 12 11 11 11 11 13 12 12 11 11 11 11 11 11 11 11 11 10 10 10 10 12 11 11 10 11 11 11 11
14 10 12 11 10 4 9 11 8 6 4 9 9 9 9 10 14 11 11 10 10 10 10 12 10 10 11 10 11 10 10 10 10 11 11 10 9 9 9 10 10 9 9 9 9 10 11 12 10 10 10 10 6 9 7 8 9 9 9 9 8 8 7 7 6 6 7 10 9 7 12 11 11 11 12 12 13 12 12 12 12 11 11 11 11 12 11 10 9 10 10 10 12 11 11 10 11 11 11 11
14 10 12 10 11 3 8 10 8 7 5 9 9 9 9 9 13 10 10 9 9 10 10 12 10 11 11 11 11 10 10 10 10 10 10 10 9 9 9 10 10 10 10 10 10 11 12 12 11 11 11 11 5 8 7 9 9 9 9 9 8 8 8 8 7 6 7 9 9 7 12 11 11 11 11 13 12 11 12 12 12 11 11 11 11 12 11 11 11 10 10 10 11 12 11 10 11 11 11 11
16 10 12 11 11 3 8 10 8 8 7 9 8 8 8 8 12 10 11 10 10 11 11 11 9 9 9 10 9 10 10 10 10 10 9 10 10 11 11 11 10 10 11 11 11 11 11 10 10 10 10 10 6 7 7 9 9 9 9 9 9 8 8 7 7 6 6 7 7 7 12 11 11 12 11 12 12 12 12 12 12 11 11 11 11 12 11 11 11 11 11 11 11 10 11 11 11 11 11 11
16 10 12 10 11 4 8 10 7 6 6 8 9 9 9 9 12 11 11 10 9 10 10 10 9 9 9 10 11 11 10 10 11 10 9 9 10 10 10 11 11 11 11 11 10 10 11 10 10 10 10 10 6 7 7 9 9 9 9 9 9 8 8 7 6 6 6 6 5 7 11 11 11 12 11 12 12 12 12 12 12 11 12 12 11 11 11 11 11 11 11 11 11 11 11 11 11 11 11 11
15 10 11 11 11 4 8 10 7 7 8 8 8 9 9 9 12 10 10 9 8 9 9 11 9 9 10 10 11 11 11 11 11 11 10 10 10 11 10 10 11 11 11 10 11 10 10 10 10 11 11 10 7 7 7 10 9 9 9 9 9 9 8 8 7 7 7 6 5 7 11 11 12 11 11 12 11 12 12 12 11 11 12 11 11 11 11 11 11 11 11 11 11 11 11 11 11 11 10 11
16 10 12 10 11 4 7 10 7 8 8 8 8 9 9 9 12 10 10 9 9 8 8 11 10 10 11 10 10 11 13 13 12 11 11 11 11 11 11 11 11 11 10 11 11 10 11 11 11 11 10 10 6 6 7 9 10 9 9 9 9 9 9 8 8 7 7 6 6 6 10 12 12 11 11 11 12 12 12 12 13 12 12 11 10 10 11 12 11 10 11 11 11 11 11 11 11 11 11 11
15 9 11 10 11 5 7 10 8 8 8 8 8 9 9 9 12 9 10 9 8 9 10 11 10 10 10 10 11 11 12 12 12 11 11 11 11 11 11 11 11 11 11 11 11 10 10 11 11 11 10 9 6 7 9 10 9 10 9 10 10 9 9 8 8 7 6 6 6 5 10 12 12 12 11 11 12 12 12 12 12 12 11 11 10 10 11 11 11 11 10 11 11 11 11 11 11 11 11 11
16 9 10 10 11 4 8 11 7 7 8 8 8 8 8 9 12 9 10 11 10 10 11 10 10 10 10 10 10 10 10 11 12 12 12 11 11 12 11 11 11 11 11 11 11 10 10 10 10 10 10 10 6 8 10 9 10 9 9 9 9 9 9 8 8 7 6 7 6 4 9 12 12 12 11 11 12 12 11 11 12 11 11 11 11 10 11 11 11 12 11 10 10 11 11 11 11 11 11 11
16 9 10 10 10 6 8 11 7 8 8 8 8 8 8 8 11 10 10 9 9 10 10 11 10 10 10 10 11 11 12 12 11 11 12 12 11 12 11 10 10 11 11 11 11 11 11 10 10 10 10 10 6 8 10 9 10 10 10 9 8 8 9 8 7 7 6 7 6 4 8 11 11 11 11 12 13 12 10 11 12 11 11 11 11 11 11 11 11 12 12 11 10 10 11 11 11 11 11 11
16 9 10 10 9 7 9 11 7 8 7 7 7 7 7 7 12 10 11 10 10 9 10 10 10 10 10 11 12 12 12 11 12 11 12 12 11 11 11 11 11 11 11 11 11 11 11 10 9 10 9 9 6 8 10 10 9 9 9 9 8 8 8 8 8 7 6 6 5 5 7 10 11 11 11 12 12 13 11 11 12 11 11 11 11 11 11 11 11 12 11 11 11 11 10 11 11 11 11 11
16 8 9 10 8 7 9 10 7 7 7 7 7 8 8 9 12 10 11 10 10 9 10 10 11 11 10 11 12 11 11 11 11 11 11 11 11 12 12 11 11 11 11 11 11 10 10 9 9 9 10 10 6 8 9 10 9 9 8 8 8 8 8 8 8 7 7 7 6 5 6 9 11 11 11 11 12 13 13 11 11 12 11 11 11 11 11 10 10 12 11 11 11 11 11 10 10 11 11 11
16 8 10 10 7 7 9 10 8 8 8 8 8 9 9 9 11 10 10 10 10 10 10 10 10 11 10 11 11 11 11 11 11 11 11 11 11 12 12 12 11 11 10 10 10 11 10 10 10 10 10 10 6 9 8 9 9 9 9 9 9 8 8 7 7 7 7 7 6 5 5 7 10 12 11 11 11 12 13 12 11 12 12 11 11 11 11 11 11 11 11 11 11 11 11 11 11 10 10 11
15 8 11 9 7 7 8 11 8 9 9 9 10 10 10 9 12 11 10 10 10 10 10 10 10 10 9 10 10 10 10 10 11 11 11 11 12 12 11 11 10 11 12 11 11 10 10 10 10 10 10 10 6 8 8 8 8 9 9 9 8 8 8 8 7 7 6 7 5 5 5 6 9 11 11 12 11 12 12 13 11 11 11 12 11 10 11 11 11 11 11 11 11 11 11 11 11 12 10 10
13 8 10 8 7 8 8 11 8 9 9 10 10 9 10 9 12 10 10 10 10 10 10 10 10 10 10 10 10 10 11 11 11 12 11 11 11 11 11 11 11 11 10 11 11 10 9 9 9 9 9 9 6 8 9 8 8 8 8 7 8 7 7 8 7 7 6 6 5 5 6 5 8 10 11 11 12 12 13 12 10 11 11 12 11 11 11 11 11 11 11 11 11 11 11 11 11 11 11 11
15 8 9 9 8 8 9 10 9 9 10 10 10 10 10 10 11 10 10 9 9 10 10 10 10 9 9 9 10 10 11 10 10 10 11 12 11 11 11 11 10 11 11 11 10 10 9 9 9 8 8 8 7 9 8 8 8 8 7 7 7 7 7 7 7 7 6 7 5 5 6 5 6 8 10 11 12 12 13 12 10 11 12 11 11 11 10 11 11 11 11 11 11 10 11 11 11 11 11 11
14 7 8 9 9 8 9 10 8 9 9 9 9 9 9 9 11 10 9 9 9 10 9 10 10 9 8 8 9 9 10 9 9 10 10 11 11 11 11 10 10 10 10 9 9 9 8 9 9 9 9 9 7 9 9 8 8 8 8 7 7 7 8 7 7 7 7 7 5 5 5 5 6 6 9 11 12 11 13 12 11 11 12 11 11 11 11 11 11 11 11 11 12 10 9 10 11 11 11 11
14 8 8 8 9 8 9 10 9 9 9 9 9 9 9 8 9 9 9 9 9 9 9 10 10 9 10 9 9 8 9 9 9 10 12 11 12 11 10 10 10 9 9 9 8 8 8 9 9 8 9 9 6 8 8 8 7 7 7 8 8 7 6 8 7 7 7 6 4 4 5 5 6 5 7 10 11 11 12 12 11 11 11 11 11 11 11 11 11 10 11 11 11 11 9 9 11 11 11 11
13 7 7 7 7 7 9 10 8 9 9 9 9 9 9 9 7 9 9 9 10 9 8 9 8 8 8 9 8 9 9 10 10 11 12 12 11 11 10 10 10 9 9 8 9 9 10 9 9 9 8 8 6 7 7 7 7 7 8 8 8 8 7 7 7 6 7 6 4 4 5 5 5 4 6 8 11 11 12 11 11 12 11 11 11 11 11 11 11 10 11 11 11 11 11 10 10 11 11 11
14 7 7 8 8 8 8 11 8 9 9 9 8 8 8 9 7 8 10 8 8 8 8 9 8 8 8 9 10 9 9 10 10 11 11 10 11 9 10 9 10 10 9 9 8 9 10 9 9 9 9 9 8 7 7 7 7 8 7 8 8 8 8 7 7 7 6 6 4 4 5 4 4 4 5 7 10 11 11 12 11 11 11 11 11 11 11 11 11 12 11 11 11 11 11 11 10 10 11 11
14 6 7 8 7 7 8 10 7 8 8 9 8 8 8 8 6 8 9 8 8 8 9 8 8 9 8 9 8 8 8 10 10 10 10 10 10 9 10 10 10 9 9 9 9 9 8 9 9 8 9 9 8 7 8 7 8 10 9 8 8 7 7 7 8 7 7 6 4 4 5 5 5 5 4 6 10 10 12 12 11 11 11 11 11 11 12 11 11 12 12 10 11 11 11 11 11 11 10 10
12 6 7 7 7 7 7 9 6 8 7 7 8 8 8 8 8 9 8 8 9 8 9 9 8 8 8 8 8 9 9 11 10 10 11 11 10 10 10 10 9 10 9 9 9 9 8 8 10 9 8 8 8 8 8 8 7 8 8 7 7 7 7 7 7 7 6 7 4 3 4 4 4 5 4 5 10 11 11 11 11 11 11 11 11 11 11 11 11 11 12 11 10 11 11 11 11 10 10 10
11 7 6 6 7 7 7 8 7 7 7 7 8 8 8 9 9 8 9 9 9 9 9 8 8 8 8 8 8 8 9 12 11 12 12 11 9 10 10 9 9 10 8 8 9 8 9 9 8 8 8 8 9 8 9 9 8 7 7 8 8 6 7 7 6 6 6 5 3 2 3 3 4 7 5 4 10 12 10 11 11 11 11 11 11 11 11 11 11 11 11 12 11 10 10 11 11 10 10 11
10 8 6 6 6 7 7 8 7 7 7 8 8 7 8 9 10 8 9 9 8 8 9 7 8 7 8 8 9 9 11 13 12 11 10 11 9 10 10 10 9 10 9 8 9 8 8 10 9 8 8 8 8 8 9 9 8 7 7 7 7 6 7 7 7 7 7 4 4 3 4 3 4 4 4 5 10 12 11 11 11 11 11 11 11 11 11 11 11 11 11 11 12 12 11 10 11 10 10 11
7 7 7 6 7 8 8 8 7 8 8 8 7 7 8 9 10 8 8 9 7 7 7 7 7 7 7 8 8 8 9 10 10 10 11 11 10 8 9 8 9 9 8 8 8 8 8 8 8 8 7 8 7 7 8 8 7 8 8 7 6 6 6 6 6 6 6 5 5 6 5 5 5 5 5 5 9 12 11 11 11 11 11 11 11 11 11 11 11 11 11 11 12 11 12 11 10 10 10 11
7 7 7 6 7 8 9 9 8 8 8 8 8 8 8 8 8 8 7 6 5 5 6 6 7 7 8 8 9 9 9 9 10 12 12 9 10 9 8 9 9 8 7 8 8 8 9 8 8 7 7 9 8 7 8 7 7 7 8 7 7 6 6 6 6 6 5 4 5 6 6 4 4 4 4 5 9 11 11 11 11 11 11 11 11 11 11 11 11 11 11 11 11 11 11 11 10 10 10 10
6 6 8 7 7 8 7 7 8 8 8 8 8 9 7 7 8 7 7 7 7 7 6 7 7 8 7 7 8 9 9 9 11 12 11 10 9 9 9 9 8 8 9 9 9 8 9 9 8 8 9 8 9 8 8 8 8 9 8 8 7 6 6 6 5 5 5 4 5 6 6 5 4 4 4 6 7 10 10 12 11 11 11 11 11 11 11 10 11 11 11 11 11 11 11 11 11 10 10 10
6 6 7 7 7 8 8 8 7 7 8 9 10 8 7 7 8 7 7 7 7 7 7 8 8 8 8 8 8 10 11 10 9 10 10 10 10 8 8 9 8 8 8 8 8 9 8 8 7 8 8 8 8 8 8 8 8 8 8 6 8 7 6 6 6 5 5 6 6 5 6 6 5 4 4 5 6 8 10 11 11 11 11 11 11 11 11 11 10 11 10 11 11 11 11 11 11 12 10 10
6 7 7 9 7 7 7 6 7 7 7 8 9 7 7 8 7 7 6 7 8 8 8 7 8 9 9 10 10 9 10 10 10 10 10 10 9 9 8 8 9 9 7 8 8 8 8 8 8 9 9 8 8 8 8 8 9 7 7 6 7 7 5 6 5 5 6 7 6 6 7 5 5 5 5 5 5 7 7 10 11 10 11 11 11 11 11 12 11 10 10 11 11 11 11 11 11 12 12 10
6 6 7 8 7 7 9 7 8 8 7 8 9 9 9 6 6 6 7 7 7 8 8 8 7 9 10 10 10 9 9 10 11 10 10 9 9 9 8 8 9 8 8 8 8 8 8 9 9 8 8 8 9 8 8 7 7 7 7 7 6 7 5 5 6 5 6 6 5 7 7 5 4 5 7 5 4 6 5 8 10 10 11 11 11 11 11 12 11 10 10 10 11 10 11 11 11 12 12 12
7 7 6 6 7 8 8 8 7 9 10 9 8 6 5 4 6 6 7 8 8 8 8 8 8 8 9 9 10 10 10 10 10 9 9 9 8 9 9 8 9 8 9 9 8 9 8 9 9 8 8 8 8 8 7 7 6 6 6 6 7 6 5 5 6 6 6 5 5 5 5 5 4 5 7 6 5 6 6 8 10 11 11 11 11 11 11 11 11 11 10 10 11 11 11 10 11 12 12 12
7 6 8 7 7 8 8 7 6 7 8 7 5 5 5 5 7 7 7 8 9 8 8 7 9 9 8 10 9 10 10 9 9 10 9 9 9 9 10 9 9 9 9 10 8 8 7 8 8 8 8 7 8 8 7 7 6 5 6 6 6 6 6 6 7 6 5 5 5 5 5 4 4 4 4 6 7 7 7 6 9 10 11 11 11 11 11 11 11 11 11 11 11 11 11 11 11 12 12 11
7 6 7 6 7 7 5 6 6 6 5 6 7 6 6 7 7 8 8 8 7 6 7 7 9 9 9 9 8 8 10 10 10 10 9 9 9 9 9 8 8 9 9 9 9 8 7 8 8 8 8 7 7 8 8 7 5 5 6 6 6 5 6 6 6 5 5 5 4 6 5 5 5 4 5 6 6 5 5 5 8 10 12 11 12 11 10 11 11 11 11 11 11 11 10 11 11 11 12 11
6 6 6 6 6 5 6 8 6 7 7 7 7 7 7 7 7 7 7 6 6 6 6 7 7 8 9 9 9 10 11 10 10 9 8 9 9 9 9 8 7 8 8 9 8 8 8 8 7 7 8 7 7 8 8 7 6 5 6 6 6 6 6 6 6 6 5 5 5 7 6 5 5 4 4 4 5 5 5 5 6 9 12 11 11 12 10 11 11 11 11 11 11 11 10 10 11 11 11 11
7 7 6 6 7 6 6 6 7 7 7 6 7 7 7 7 6 7 7 7 6 7 7 7 7 8 8 8 10 10 11 10 9 9 9 9 9 8 9 9 8 7 8 8 8 8 7 8 8 7 8 7 8 7 8 7 7 6 6 6 6 6 6 5 6 6 6 5 6 5 4 4 5 4 4 5 6 4 5 5 4 6 10 12 11 11 10 11 11 11 11 11 11 10 10 10 11 12 11 11
7 6 7 7 7 8 8 8 7 8 8 8 8 7 7 7 7 6 7 7 7 8 8 7 8 8 9 10 10 10 9 10 9 10 9 8 6 7 7 9 9 9 8 8 8 7 8 8 7 7 8 8 8 7 7 7 7 6 7 6 6 6 6 6 6 6 6 5 5 4 4 4 4 4 4 4 5 5 5 5 4 4 8 11 11 11 11 11 12 11 11 11 11 10 10 10 11 11 11 11
6 7 7 7 7 9 9 8 7 7 8 9 8 7 7 6 7 7 7 7 7 8 7 8 8 8 10 10 9 10 9 8 9 11 8 8 9 8 7 8 9 9 8 8 7 7 9 8 7 8 8 7 8 8 8 7 6 6 6 6 6 6 6 6 5 5 6 6 5 4 5 5 5 5 5 4 4 5 5 5 5 4 6 10 12 11 12 11 11 11 10 11 12 11 10 10 11 10 11 11
7 6 8 7 8 7 8 7 7 7 8 8 8 8 7 8 7 7 6 6 7 7 8 8 9 10 10 9 9 9 8 10 9 10 9 8 8 8 8 8 8 9 7 6 7 7 8 8 7 7 6 6 6 7 7 7 5 5 6 6 6 6 6 6 5 6 6 6 5 5 6 6 5 5 4 4 4 4 4 4 5 4 5 9 12 11 11 11 11 11 11 11 12 11 10 10 11 10 10 11
7 7 8 7 7 7 8 8 8 8 6 7 8 8 8 8 7 7 8 7 8 7 8 8 8 10 11 10 9 10 9 9 9 10 10 9 9 8 9 8 8 8 7 9 8 7 6 5 5 6 5 5 5 7 7 8 7 6 6 6 6 6 5 6 6 5 6 5 6 5 5 6 6 5 4 4 4 5 5 4 4 5 4 7 11 11 10 11 11 11 11 11 12 11 11 10 10 10 10 11
7 8 7 7 7 8 7 8 7 7 7 8 8 9 8 8 7 7 7 9 9 8 9 9 9 9 9 7 8 8 9 10 9 9 9 9 9 9 9 8 7 7 8 8 7 6 6 6 5 6 6 6 7 7 6 6 7 8 7 6 6 6 5 5 6 5 5 5 6 6 5 6 6 6 5 4 4 4 5 4 4 4 4 6 10 11 10 11 11 11 11 11 12 11 11 11 10 10 10 11
7 7 7 7 7 7 8 7 7 7 8 7 7 7 7 8 7 8 9 9 9 9 9 9 9 9 10 11 9 9 10 9 9 8 8 9 9 8 9 7 6 6 7 6 6 7 6 6 6 6 7 6 7 6 6 7 7 6 6 8 6 6 6 6 5 5 5 6 5 6 6 6 4 6 4 4 4 4 4 4 4 4 4 4 9 10 11 11 11 11 11 10 11 11 11 11 11 10 10 11
6 6 6 7 7 7 7 6 6 7 8 7 7 7 8 7 7 8 8 8 9 9 8 7 7 8 10 12 11 9 8 8 10 9 8 9 8 8 7 7 6 6 7 5 7 7 6 6 6 6 6 6 6 7 9 8 7 7 8 8 6 5 5 5 5 5 5 6 5 6 7 5 5 6 4 4 4 4 7 6 4 4 3 3 8 10 10 10 11 11 10 10 11 11 11 11 12 11 10 11
6 6 7 7 7 7 7 7 7 7 7 8 7 7 7 8 7 7 7 7 8 8 8 9 10 8 10 10 9 9 9 9 10 9 8 9 9 8 9 8 7 7 7 6 7 8 7 6 7 6 6 7 7 7 8 8 7 6 7 7 5 6 6 5 5 6 6 6 6 6 7 5 6 5 4 4 4 4 9 8 6 4 3 2 6 10 10 10 11 11 11 10 10 11 11 10 11 12 11 10
7 7 7 8 8 7 7 8 7 7 7 7 6 7 7 9 8 7 8 9 9 8 7 8 11 10 11 10 8 9 9 8 10 7 6 9 9 9 9 8 9 7 8 7 7 7 7 7 7 7 7 7 7 6 7 8 6 6 7 6 5 6 6 5 6 7 6 7 6 6 6 7 5 4 5 4 5 5 5 5 6 5 4 3 5 9 10 9 11 11 11 11 10 10 11 11 11 11 11 11
7 8 8 7 7 8 7 7 8 8 7 7 6 6 7 8 8 8 8 8 8 8 8 9 11 10 9 8 9 9 9 8 8 7 8 8 9 9 8 8 8 6 7 7 9 7 6 7 6 7 7 6 6 6 6 7 7 6 5 6 6 6 7 7 6 6 4 6 7 6 5 5 5 5 6 4 5 5 5 4 4 4 4 4 4 6 9 9 11 12 11 11 10 10 11 11 11 11 11 11
7 7 8 7 7 8 7 7 7 8 7 7 6 6 7 8 8 8 8 8 8 8 8 7 8 9 9 8 8 7 7 8 7 7 8 7 8 8 8 8 7 6 6 7 9 7 7 7 7 6 5 6 7 8 6 7 7 7 6 6 6 7 7 7 5 6 6 6 6 5 6 7 6 5 6 4 4 4 5 5 5 4 5 6 6 6 8 8 9 12 11 11 10 10 11 11 11 11 11 11
